
10 11

7 7 7 7 7 7 7 7 7 7
7 7 7 7 7 7 7 7 7 7
7 7 7 7 7 7 7 7 7 7
7 7 7 7 7 7 7 7 7 7
7 7 7 7 7 7 7 7 7 7
7 7 0 7 7 7 0 0 7 7
7 7 0 0 7 7 7 0 7 7
7 7 0 1 0 7 7 7 7 7
7 7 0 2 4 0 7 7 7 7
7 7 0 5 6 3 0 7 7 7
7 7 0 0 0 0 0 0 7 7
