
10 15

# the list of blocks can be written on one line or spread on as many lines as wanted
7 7 7 7 7 7 7 7 7 7
7 7 7 7 7 7 7 7 7 7
7 7 7 7 7 7 7 7 7 7
7 7 7 7 7 7 7 7 7 7
7 7 7 7 7 7 7 7 7 7

7 7 7 0 0 0 7 7 7 7

7 7 1 2 3 2 1 7 7 7

7 1 4 4 6 5 4 1 7 7

7 7 1 2 3 2 1 7 7 7

7 7 7 0 0 0 7 7 7 7

7 7 7 7 7 7 7 7 7 7
7 7 7 7 7 7 7 7 7 7
7 7 7 7 7 7 7 7 7 7
7 7 7 7 7 7 7 7 7 7
7 7 7 7 7 7 7 7 7 7

