6 10

7 7 7 7 7 7
7 7 7 7 7 7
7 7 7 7 7 7
7 7 7 7 7 7

0 0 4 0 5 6
0 7 7 7 7 7
0 0 2 3 7 7
0 1 0 0 7 7
0 0 0 0 0 7
0 7 7 7 7 7


