
10 15

7 0 7 0 7 0 7 0 7 7
7 0 7 0 7 0 7 0 7 7
7 0 7 0 7 0 7 0 7 7
7 0 7 6 7 0 7 1 7 7
7 1 7 0 7 0 7 0 7 7
7 0 7 5 7 1 7 0 7 7
7 2 7 0 7 0 7 1 7 7
7 0 7 4 7 6 7 0 7 7
7 3 7 0 7 0 7 6 7 7
7 0 7 3 7 5 7 0 7 7
7 5 7 0 7 0 7 0 7 7
7 0 7 2 7 4 7 0 7 7
7 0 7 0 7 0 7 3 7 7
7 0 7 0 7 3 7 0 7 7
7 0 7 0 7 0 7 0 7 7
