
10 15

0 0 0 0 0 0 0 0 0 0
7 7 7 7 7 7 7 7 7 7
7 7 7 7 7 7 7 7 7 7
7 7 7 7 7 7 7 7 7 7
7 7 7 7 7 7 7 7 7 7
7 7 7 7 4 7 7 7 7 7
7 7 7 7 2 7 7 7 7 7
7 7 7 3 1 3 7 7 7 7
7 7 7 7 2 7 7 7 7 7
7 7 7 7 4 7 7 7 7 7
7 7 7 7 7 7 7 7 7 7
7 7 7 7 7 7 7 7 7 7
7 7 7 7 7 7 7 7 7 7
7 7 7 7 7 7 7 7 7 7
0 0 0 0 0 0 0 0 0 0
